11 16
20 20 20 20 20 20 20 20 20 20 20 
21 12 11 11 11 20 11 11 11 13 20 
20 11 20 20 11 20 11 20 20 11 20 
20 11 20 11 11 11 11 11 20 11 20 
20 11 20 11 11 11 11 11 20 11 20 
20 11 11 11 20 11 20 11 11 11 20 
20 11 11 11 11 10 11 11 11 11 20 
20 11 11 11 11 20 11 11 11 11 20 
10 11 20 20 11 20 11 20 20 11 10 
20 11 11 11 11 10 11 11 11 11 20 
20 11 11 11 20 11 20 11 11 11 20 
20 11 20 11 11 11 11 11 20 11 20 
20 11 20 11 11 11 11 11 20 11 20 
20 11 20 20 11 20 11 20 20 11 20 
20 14 11 11 11 20 11 11 11 12 20 
20 20 20 20 20 20 20 20 20 20 20 
0 0
0 1
1 0
0 8
10 8
